Date,Q-P1,S-P2,Q-P2,Volume,Currency,TP,
20/04/2018,40150,40000,80150,4164231,VND,Ha Long,
23/04/2018,42300,41300,83600,1940924,VND,Mong Cai,
24/04/2018,41850,41300,83150,2291985,VND,Cam Pha,
26/04/2018,41900,41400,83300,1306023,VND,Uong Bi,
27/04/2018,41800,40800,82600,1656048,VND,Bac Kan,
2/5/2018,41000,40800,81800,990949,VND,Pho Yen,
3/5/2018,42000,40000,82000,861454,VND,Thai Nguyen,
4/5/2018,14410,13960,28370,565484,VND,Song Cong,
7/5/2018,14149,13818,27967,570133,VND,Bac Ninh,
8/5/2018,14670,14102,28772,1175366,VND,Tu Son,
9/5/2018,14244,14007,28251,779611,VND,Hai Duong,
10/5/2018,14197,13724,27921,390915,VND,Chi Linh,
11/5/2018,13960,13534,27494,1532914,VND,Hung Yen,
14/05/2018,14102,13629,27731,534463,VND,Viet Tri,
15/05/2018,13960,13629,27589,990337,VND,Phu Tho,
16/05/2018,14102,13818,27920,1110132,VND,Yen Bai,
17/05/2018,14007,13865,27872,815070,VND,Lao Cai,
18/05/2018,13913,13795,27708,984631,VND,Lai Chau,
21/05/2018,14078,13936,28014,717421,VND,Son La,
22/05/2018,13984,13534,27518,876120,VND,Dien Bien Phu,
23/05/2018,13865,13676,27541,1069432,VND,Hoa Binh,
24/05/2018,13889,13771,27660,775300,VND,Ha Noi,
25/05/2018,13865,13700,27565,650835,VND,Ha Giang,
28/05/2018,13629,12824,26453,416379,VND,Cao Bang,
29/05/2018,13014,13014,26028,1247636,VND,Tuyen Quang,
30/05/2018,13605,13440,27045,362366,VND,Lang Son,
31/05/2018,13534,13250,26784,607219,VND,Quang Ninh,
1/6/2018,13534,13250,26784,212479,VND,Bac Giang,
4/6/2018,13298,13227,26525,819276,VND,Hai Phong,
5/6/2018,14007,13676,27683,970367,VND,Nam Dinh,
6/6/2018,13818,13629,27447,1791777,VND,Thai Binh,
7/6/2018,13724,13582,27306,1427593,VND,Ninh Binh,
8/6/2018,13676,13487,27163,2456601,VND,Thanh Hoa,
11/6/2018,13676,13345,27021,81801,VND,Sam Son,
12/6/2018,13487,13156,26643,89133,VND,Nghe An,
13/06/2018,13345,13250,26595,234963,VND,Vinh,
14/06/2018,13345,13132,26477,48582,VND,Ha Tinh,
15/06/2018,13321,13132,26453,55492,VND,Quang Binh,
18/06/2018,13156,12777,25933,94015,VND,Dong Hoi,
19/06/2018,12588,11902,24490,1371151,VND,Quang Tri,
20/06/2018,12824,12824,25648,1370876,VND,Dong Ha,
21/06/2018,13061,12777,25838,92261,VND,Hue,
22/06/2018,12919,12919,25838,243691,VND,Quang Nam,
25/06/2018,13037,13014,26051,433178,VND,Tam Ky,
26/06/2018,12398,12398,24796,214360,VND,Hoi An,
27/06/2018,13108,12777,25885,89514,VND,Quang Ngai,
28/06/2018,13085,12777,25862,93761,VND,Quang Ngai,
29/06/2018,13014,12730,25744,495728,VND,Binh Dinh,
2/7/2018,13014,12753,25767,156290,VND,Quy Nhon,
3/7/2018,12777,12280,25057,385083,VND,Phu Yen,
4/7/2018,12351,11736,24087,599781,VND,Tuy Hoa,
5/7/2018,12257,11973,24230,1646518,VND,Khanh Hoa,
6/7/2018,11973,11973,23946,727184,VND,Nha Trang,
9/7/2018,12777,11760,24537,478654,VND,Cam Ranh,
10/7/2018,12777,12730,25507,589025,VND,Dak Lak,
11/7/2018,12872,12588,25460,174189,VND,Buon Ma Thuot,
12/7/2018,12635,12564,25199,293540,VND,Dak Nong,
13/07/2018,12848,12730,25578,641875,VND,Gia Lai,
16/07/2018,12777,12540,25317,457374,VND,Pleiku,
17/07/2018,12777,12682,25459,333416,VND,Kon Tum,
18/07/2018,12706,12611,25317,523601,VND,Kon Tum,
19/07/2018,12753,12635,25388,116541,VND,Gia Lai,
20/07/2018,12777,12682,25459,54076,VND,An Giang,
23/07/2018,12753,12635,25388,138941,VND,Long Xuyen,
24/07/2018,12777,11831,24608,166264,VND,Can Tho,
25/07/2018,12588,11831,24419,209014,VND,Rach Gia,
26/07/2018,12493,12469,24962,155783,VND,Kien Giang,
27/07/2018,12540,12469,25009,220256,VND,Ha Tien,
30/07/2018,12257,11878,24135,459973,VND,Ca Mau,
31/07/2018,11854,11854,23708,278241,VND,Ca Mau,
1/8/2018,11996,11831,23827,284348,VND,Bac Lieu,
2/8/2018,11807,11357,23164,397318,VND,Soc Trang,
3/8/2018,11357,11357,22714,423310,VND,Soc Trang,
6/8/2018,11665,11263,22928,636761,VND,Vinh Long,
7/8/2018,11334,11334,22668,202780,VND,Vinh Long,
8/8/2018,11381,11381,22762,475843,VND,Tra Vinh,
9/8/2018,11594,11594,23188,974615,VND,Ben Tre,
10/8/2018,12044,11878,23922,701804,VND,Ben Tre,
13/08/2018,12115,11996,24111,711821,VND,Tien Giang,
14/08/2018,12446,12304,24750,660746,VND,My Tho,
15/08/2018,12304,12162,24466,612079,VND,Long An,
16/08/2018,12115,12115,24230,496595,VND,Tan An,
17/08/2018,12446,12328,24774,554538,VND,Dong Nai,
20/08/2018,12304,12304,24608,602655,VND,Bien Hoa,
21/08/2018,12304,12304,24608,659330,VND,Binh Duong,
22/08/2018,12422,12351,24773,920539,VND,Thu Dau Mot,
23/08/2018,12398,12398,24796,793960,VND,Di An,
24/08/2018,12564,12493,25057,673573,VND,Tay Ninh,
27/08/2018,12588,12588,25176,555510,VND,Tay Ninh,
28/08/2018,12588,12588,25176,777181,VND,Binh Phuoc,
29/08/2018,12730,12682,25412,746561,VND,Dong Xoai,
30/08/2018,12777,12682,25459,815979,VND,Phu Quoc,
31/08/2018,12801,12730,25531,728494,VND,Vung Tau,
4/9/2018,12706,12659,25365,581016,VND,Ba Ria - Vung Tau,
5/9/2018,12659,12540,25199,607261,VND,Ho Chi Minh,
6/9/2018,12493,11665,24158,664592,VND,Thu Duc,
7/9/2018,12186,12162,24348,706284,VND,Ha Long,
10/9/2018,12517,12422,24939,623469,VND,Mong Cai,
11/9/2018,12469,12351,24820,646630,VND,Cam Pha,
12/9/2018,12351,12304,24655,657851,VND,Uong Bi,
13/09/2018,12375,12351,24726,579684,VND,Bac Kan,
14/09/2018,12398,12375,24773,625984,VND,Pho Yen,
17/09/2018,12398,12304,24702,627210,VND,Thai Nguyen,
18/09/2018,12351,12091,24442,721246,VND,Song Cong,
19/09/2018,12375,12304,24679,852410,VND,Bac Ninh,
20/09/2018,12422,12398,24820,954413,VND,Tu Son,
21/09/2018,12422,12398,24820,969923,VND,Hai Duong,
24/09/2018,12446,12398,24844,379948,VND,Chi Linh,
25/09/2018,12422,12233,24655,745103,VND,Hung Yen,
26/09/2018,12304,12209,24513,593314,VND,Viet Tri,
27/09/2018,12304,12280,24584,502068,VND,Phu Tho,
28/09/2018,12304,12257,24561,796855,VND,Yen Bai,
1/10/2018,12398,12375,24773,707890,VND,Lao Cai,
2/10/2018,12398,12280,24678,977784,VND,Lai Chau,
3/10/2018,12398,12375,24773,1042151,VND,Son La,
4/10/2018,12446,12446,24892,1940650,VND,Dien Bien Phu,
5/10/2018,12824,12706,25530,1461151,VND,Hoa Binh,
8/10/2018,12801,12540,25341,1240388,VND,Ha Noi,
9/10/2018,12493,12446,24939,2252321,VND,Ha Giang,
10/10/2018,12635,12588,25223,1178810,VND,Cao Bang,
11/10/2018,11831,11783,23614,1058465,VND,Tuyen Quang,
12/10/2018,11760,11760,23520,795608,VND,Lang Son,
15/10/2018,11878,11073,22951,711187,VND,Quang Ninh,
16/10/2018,11381,11357,22738,694831,VND,Bac Giang,
17/10/2018,11452,11452,22904,679489,VND,Hai Phong,
18/10/2018,11618,11547,23165,589954,VND,Nam Dinh,
19/10/2018,11547,11452,22999,651257,VND,Thai Binh,
22/10/2018,11570,11570,23140,816613,VND,Ninh Binh,
23/10/2018,11665,11523,23188,667254,VND,Thanh Hoa,
24/10/2018,11570,11547,23117,668226,VND,Sam Son,
25/10/2018,11570,11428,22998,528102,VND,Nghe An,
26/10/2018,11665,11665,23330,569710,VND,Vinh,
29/10/2018,11760,11665,23425,458663,VND,Ha Tinh,
30/10/2018,11760,11760,23520,778386,VND,Quang Binh,
31/10/2018,12067,12067,24134,651532,VND,Dong Hoi,
1/11/2018,12540,12162,24702,602972,VND,Quang Tri,
2/11/2018,12209,11357,23566,1080484,VND,Dong Ha,
5/11/2018,11594,11570,23164,1017913,VND,Hue,
6/11/2018,11712,11689,23401,524636,VND,Quang Nam,
7/11/2018,11712,11712,23424,539830,VND,Tam Ky,
8/11/2018,11831,11665,23496,1335163,VND,Hoi An,
9/11/2018,11973,11831,23804,1190559,VND,Quang Ngai,
12/11/2018,11878,11807,23685,496426,VND,Quang Ngai,
13/11/2018,12067,11949,24016,437363,VND,Binh Dinh,
14/11/2018,12044,12044,24088,381744,VND,Quy Nhon,
15/11/2018,12091,12020,24111,494249,VND,Phu Yen,
16/11/2018,12115,12115,24230,532814,VND,Tuy Hoa,
19/11/2018,12304,12304,24608,700748,VND,Khanh Hoa,
20/11/2018,12422,12351,24773,605254,VND,Nha Trang,
21/11/2018,12398,12280,24678,650433,VND,Cam Ranh,
22/11/2018,13014,12730,25744,2667897,VND,Dak Lak,
23/11/2018,13298,12966,26264,2229879,VND,Buon Ma Thuot,
26/11/2018,12540,12517,25057,1269064,VND,Dak Nong,
27/11/2018,12493,12162,24655,662161,VND,Gia Lai,
28/11/2018,12257,11831,24088,662563,VND,Pleiku,
29/11/2018,12209,11996,24205,501751,VND,Kon Tum,
30/11/2018,12162,11807,23969,810654,VND,Kon Tum,
3/12/2018,12257,12067,24324,1000691,VND,Gia Lai,
4/12/2018,12517,12304,24821,649757,VND,An Giang,
5/12/2018,12304,12233,24537,971191,VND,Long Xuyen,
6/12/2018,12540,12446,24986,1216044,VND,Can Tho,
7/12/2018,13338,12974,26312,1431343,VND,Rach Gia,
10/12/2018,13277,13005,26282,737329,VND,Kien Giang,
11/12/2018,13005,12792,25797,530061,VND,Ha Tien,
12/12/2018,12823,12823,25646,351213,VND,Ca Mau,
13/12/2018,13035,12883,25918,368153,VND,Ca Mau,
14/12/2018,12974,12792,25766,534449,VND,Bac Lieu,
17/12/2018,12792,12429,25221,389546,VND,Soc Trang,
18/12/2018,12489,12186,24675,671500,VND,Soc Trang,
19/12/2018,12489,12125,24614,451862,VND,Vinh Long,
20/12/2018,12307,12277,24584,319000,VND,Vinh Long,
21/12/2018,12247,12156,24403,435681,VND,Tra Vinh,
24/12/2018,12247,12125,24372,290052,VND,Ben Tre,
25/12/2018,12125,11519,23644,338579,VND,Ben Tre,
26/12/2018,11701,11701,23402,362495,VND,Tien Giang,
27/12/2018,12429,12095,24524,302522,VND,My Tho,
28/12/2018,12125,11883,24008,267637,VND,Long An,
2/1/2019,12307,11822,24129,168011,VND,Tan An,
3/1/2019,12065,11731,23796,144820,VND,Dong Nai,
4/1/2019,11822,11337,23159,269435,VND,Bien Hoa,
7/1/2019,12186,11792,23978,166114,VND,Binh Duong,
8/1/2019,12004,11853,23857,239003,VND,Thu Dau Mot,
9/1/2019,12125,12065,24190,1304568,VND,Di An,
10/1/2019,12489,12489,24978,785508,VND,Tay Ninh,
11/1/2019,12732,12610,25342,651806,VND,Tay Ninh,
14/01/2019,12732,11822,24554,438270,VND,Binh Phuoc,
15/01/2019,13065,12550,25615,729906,VND,Dong Xoai,
16/01/2019,12823,12610,25433,199631,VND,Phu Quoc,
17/01/2019,12732,12520,25252,170584,VND,Vung Tau,
18/01/2019,12550,12550,25100,225032,VND,Ha Long,
21/01/2019,12641,12610,25251,476883,VND,Mong Cai,
22/01/2019,12914,12610,25524,357300,VND,Cam Pha,
23/01/2019,12671,12550,25221,1570605,VND,Uong Bi,
24/01/2019,12792,12732,25524,448546,VND,Bac Kan,
25/01/2019,12914,12823,25737,595923,VND,Pho Yen,
28/01/2019,12883,12732,25615,378330,VND,Thai Nguyen,
29/01/2019,12762,12520,25282,457140,VND,Song Cong,
30/01/2019,12732,12641,25373,316278,VND,Bac Ninh,
31/01/2019,12732,12610,25342,320056,VND,Tu Son,
1/2/2019,12671,12610,25281,219968,VND,Hai Duong,
11/2/2019,12853,12762,25615,541211,VND,Chi Linh,
12/2/2019,12914,12883,25797,639600,VND,Hung Yen,
13/02/2019,12944,12853,25797,508388,VND,Viet Tri,
14/02/2019,12974,12823,25797,541921,VND,Phu Tho,
15/02/2019,12944,12732,25676,885546,VND,Yen Bai,
18/02/2019,12944,12762,25706,456925,VND,Lao Cai,
19/02/2019,12914,12732,25646,462962,VND,Lai Chau,
20/02/2019,12853,12610,25463,576954,VND,Son La,
21/02/2019,12823,12580,25403,783777,VND,Dien Bien Phu,
22/02/2019,12641,12580,25221,574200,VND,Hoa Binh,
25/02/2019,12762,12762,25524,546704,VND,Ha Noi,
26/02/2019,12883,12610,25493,760206,VND,Ha Giang,
27/02/2019,12732,12550,25282,965379,VND,Cao Bang,
28/02/2019,12701,12520,25221,871345,VND,Tuyen Quang,
1/3/2019,12580,12550,25130,764049,VND,Lang Son,
4/3/2019,12701,12641,25342,1022482,VND,Quang Ninh,
5/3/2019,12853,12610,25463,1023983,VND,Bac Giang,
6/3/2019,12701,12610,25311,308971,VND,Hai Phong,
7/3/2019,12732,12701,25433,470533,VND,Nam Dinh,
8/3/2019,12701,12580,25281,219490,VND,Thai Binh,
11/3/2019,12610,12520,25130,98240,VND,Ninh Binh,
12/3/2019,12610,12610,25220,1100599,VND,Thanh Hoa,
13/03/2019,12944,12853,25797,905406,VND,Sam Son,
14/03/2019,12944,12732,25676,461692,VND,Nghe An,
15/03/2019,12883,12732,25615,574315,VND,Vinh,
18/03/2019,12732,12732,25464,1549426,VND,Ha Tinh,
19/03/2019,12914,12823,25737,1273212,VND,Quang Binh,
20/03/2019,12883,12701,25584,1140450,VND,Dong Hoi,
21/03/2019,12914,12671,25585,832897,VND,Quang Tri,
22/03/2019,12853,12792,25645,562011,VND,Dong Ha,
25/03/2019,12823,12550,25373,776024,VND,Hue,
26/03/2019,12671,12671,25342,556089,VND,Quang Nam,
27/03/2019,12701,12641,25342,530325,VND,Ha Long,
28/03/2019,12762,12701,25463,833177,VND,Mong Cai,
29/03/2019,12914,12883,25797,829367,VND,Cam Pha,
1/4/2019,12914,12823,25737,1305063,VND,Uong Bi,
2/4/2019,13702,13459,27161,1204019,VND,Bac Kan,
3/4/2019,13520,13459,26979,1966765,VND,Pho Yen,
4/4/2019,13732,13611,27343,1368368,VND,Thai Nguyen,
5/4/2019,13823,13762,27585,1109589,VND,Song Cong,
8/4/2019,13793,13732,27525,1493906,VND,Bac Ninh,
9/4/2019,13914,13702,27616,2637688,VND,Tu Son,
10/4/2019,13641,13247,26888,1097977,VND,Hai Duong,
11/4/2019,13429,13399,26828,1434889,VND,Chi Linh,
12/4/2019,13823,13520,27343,337441,VND,Hung Yen,
16/04/2019,13550,13308,26858,579824,VND,Viet Tri,
17/04/2019,13459,13277,26736,913537,VND,Phu Tho,
18/04/2019,13429,13217,26646,1198559,VND,Yen Bai,
19/04/2019,13308,13156,26464,1231531,VND,Lao Cai,
22/04/2019,13520,13095,26615,1335297,VND,Lai Chau,
23/04/2019,13338,13005,26343,1738467,VND,Son La,
24/04/2019,13186,13005,26191,1619593,VND,Dien Bien Phu,
25/04/2019,13035,12853,25888,845911,VND,Hoa Binh,
26/04/2019,12853,12853,25706,1728472,VND,Ha Noi,
2/5/2019,12944,12914,25858,1450559,VND,Ha Giang,
3/5/2019,12944,12823,25767,1880846,VND,Cao Bang,
6/5/2019,12853,12671,25524,536378,VND,Tuyen Quang,
7/5/2019,12914,12914,25828,2786961,VND,Lang Son,
8/5/2019,12944,12944,25888,896383,VND,Quang Ninh,
9/5/2019,13035,13005,26040,2828246,VND,Bac Giang,
10/5/2019,13247,13095,26342,4248538,VND,Hai Phong,
13/05/2019,13702,13702,27404,2516471,VND,Nam Dinh,
14/05/2019,13823,13762,27585,2189785,VND,Thai Binh,
15/05/2019,13944,13884,27828,3606563,VND,Ninh Binh,
16/05/2019,14096,13975,28071,2643708,VND,Thanh Hoa,
17/05/2019,14156,14126,28282,1631716,VND,Sam Son,
20/05/2019,14460,14338,28798,925034,VND,Nghe An,
21/05/2019,14490,14399,28889,967177,VND,Vinh,
22/05/2019,14581,14429,29010,900408,VND,Ha Tinh,
23/05/2019,14490,14247,28737,890759,VND,Quang Binh,
24/05/2019,14247,14187,28434,1000330,VND,Dong Hoi,
27/05/2019,14308,14308,28616,1716068,VND,Quang Tri,
28/05/2019,14520,14399,28919,1563628,VND,Dong Ha,
29/05/2019,14399,14399,28798,1330184,VND,Hue,
30/05/2019,14611,14551,29162,1671599,VND,Quang Nam,
31/05/2019,14581,14460,29041,1644054,VND,Tam Ky,
3/6/2019,14490,14247,28737,1108170,VND,Hoi An,
4/6/2019,14490,14247,28737,858578,VND,Quang Ngai,
5/6/2019,14429,14399,28828,961107,VND,Quang Ngai,
6/6/2019,14551,14247,28798,760289,VND,Binh Dinh,
7/6/2019,14520,14429,28949,1278540,VND,Quy Nhon,
10/6/2019,14672,14551,29223,1518120,VND,Phu Yen,
11/6/2019,14763,14641,29404,2040874,VND,Tuy Hoa,
12/6/2019,15278,15036,30314,2209957,VND,Khanh Hoa,
13/06/2019,15096,14732,29828,5016810,VND,Nha Trang,
14/06/2019,15399,14975,30374,4507252,VND,Cam Ranh,
17/06/2019,15096,14551,29647,986426,VND,Dak Lak,
18/06/2019,14187,14187,28374,1298762,VND,Buon Ma Thuot,
19/06/2019,14005,14005,28010,497617,VND,Dak Nong,
20/06/2019,14308,14066,28374,1138751,VND,Gia Lai,
21/06/2019,14429,14126,28555,826513,VND,Pleiku,
24/06/2019,14308,13914,28222,817590,VND,Kon Tum,
25/06/2019,13914,13580,27494,1255167,VND,Kon Tum,
26/06/2019,13914,13641,27555,1009980,VND,Gia Lai,
27/06/2019,13762,13671,27433,576262,VND,An Giang,
28/06/2019,13914,13641,27555,572402,VND,Long Xuyen,
1/7/2019,13853,13823,27676,494895,VND,Can Tho,
2/7/2019,14066,13884,27950,697940,VND,Rach Gia,
3/7/2019,14096,13914,28010,1136112,VND,Ha Long,
4/7/2019,14066,13975,28041,1556716,VND,Mong Cai,
5/7/2019,14126,13944,28070,585861,VND,Cam Pha,
8/7/2019,14066,13823,27889,603395,VND,Uong Bi,
9/7/2019,13944,13884,27828,670609,VND,Bac Kan,
10/7/2019,14005,13884,27889,618273,VND,Pho Yen,
11/7/2019,13944,13884,27828,639781,VND,Thai Nguyen,
12/7/2019,13944,13823,27767,375575,VND,Song Cong,
15/07/2019,13884,13853,27737,855890,VND,Bac Ninh,
16/07/2019,14066,14066,28132,2135683,VND,Tu Son,
17/07/2019,14247,14066,28313,859106,VND,Hai Duong,
18/07/2019,14187,14005,28192,162667,VND,Chi Linh,
19/07/2019,14066,13823,27889,898396,VND,Hung Yen,
22/07/2019,13793,13732,27525,491481,VND,Viet Tri,
23/07/2019,14096,13853,27949,357382,VND,Phu Tho,
24/07/2019,14066,13823,27889,344154,VND,Yen Bai,
25/07/2019,13944,13823,27767,599849,VND,Lao Cai,
26/07/2019,13914,13823,27737,743333,VND,Lai Chau,
29/07/2019,13914,13823,27737,290712,VND,Son La,
30/07/2019,13884,13732,27616,186468,VND,Dien Bien Phu,
31/07/2019,13853,13641,27494,254573,VND,Hoa Binh,
1/8/2019,13823,13611,27434,311000,VND,Ha Noi,
2/8/2019,13611,13277,26888,805747,VND,Ha Giang,
5/8/2019,13399,13338,26737,358537,VND,Cao Bang,
6/8/2019,13641,13338,26979,244446,VND,Tuyen Quang,
7/8/2019,13641,13520,27161,170469,VND,Lang Son,
8/8/2019,13641,13429,27070,316724,VND,Quang Ninh,
9/8/2019,13671,13520,27191,512165,VND,Bac Giang,
12/8/2019,13823,13580,27403,121580,VND,Hai Phong,
13/08/2019,13641,13338,26979,726673,VND,Nam Dinh,
14/08/2019,13702,13459,27161,357283,VND,Thai Binh,
15/08/2019,13520,13429,26949,225015,VND,Ninh Binh,
16/08/2019,13580,13429,27009,221387,VND,Thanh Hoa,
19/08/2019,13580,13429,27009,228446,VND,Sam Son,
20/08/2019,13580,13459,27039,294852,VND,Nghe An,
21/08/2019,13550,13368,26918,467614,VND,Vinh,
22/08/2019,13580,13490,27070,247448,VND,Ha Tinh,
23/08/2019,13490,13490,26980,228001,VND,Quang Binh,
26/08/2019,13641,13611,27252,87436,VND,Dong Hoi,
27/08/2019,13641,13641,27282,335940,VND,Quang Tri,
28/08/2019,13702,13702,27404,197470,VND,Dong Ha,
29/08/2019,13884,13823,27707,722022,VND,Hue,
30/08/2019,14035,14035,28070,999374,VND,Quang Nam,
3/9/2019,14096,13762,27858,448744,VND,Tam Ky,
4/9/2019,13550,12883,26433,388837,VND,Hoi An,
5/9/2019,13823,13459,27282,361819,VND,Quang Ngai,
6/9/2019,13580,13338,26918,562423,VND,Quang Ngai,
9/9/2019,13580,13308,26888,526663,VND,Binh Dinh,
10/9/2019,13277,12732,26009,538671,VND,Quy Nhon,
11/9/2019,13308,13035,26343,168918,VND,Phu Yen,
12/9/2019,13399,13217,26616,131460,VND,Tuy Hoa,
13/09/2019,13399,13277,26676,420555,VND,Khanh Hoa,
16/09/2019,13641,13550,27191,106091,VND,Nha Trang,
17/09/2019,13641,13520,27161,235011,VND,Cam Ranh,
18/09/2019,13580,13520,27100,209544,VND,Dak Lak,
19/09/2019,13641,13550,27191,621868,VND,Buon Ma Thuot,
20/09/2019,13762,13308,27070,1956258,VND,Dak Nong,
23/09/2019,13550,13217,26767,756577,VND,Gia Lai,
24/09/2019,13429,13126,26555,646330,VND,Pleiku,
25/09/2019,13520,13338,26858,230904,VND,Kon Tum,
26/09/2019,13520,13338,26858,614644,VND,Kon Tum,
27/09/2019,13641,13429,27070,178666,VND,Gia Lai,
30/09/2019,13459,13459,26918,253567,VND,An Giang,
1/10/2019,13580,13459,27039,814077,VND,Long Xuyen,
2/10/2019,13580,13550,27130,398948,VND,Can Tho,
3/10/2019,13641,13520,27161,231778,VND,Rach Gia,
4/10/2019,13580,13459,27039,473519,VND,Kien Giang,
7/10/2019,13580,13459,27039,459070,VND,Ha Tien,
8/10/2019,13520,13399,26919,159599,VND,Ca Mau,
9/10/2019,13580,13520,27100,149208,VND,Ca Mau,
10/10/2019,13611,13459,27070,348261,VND,Ha Long,
11/10/2019,13580,13429,27009,227902,VND,Mong Cai,
14/10/2019,13580,13459,27039,908721,VND,Cam Pha,
15/10/2019,13580,13490,27070,296089,VND,Uong Bi,
16/10/2019,13580,13520,27100,245336,VND,Bac Kan,
17/10/2019,13550,13550,27100,2093788,VND,Pho Yen,
18/10/2019,13732,13611,27343,402890,VND,Thai Nguyen,
21/10/2019,13762,13580,27342,160077,VND,Song Cong,
22/10/2019,13641,13550,27191,324410,VND,Bac Ninh,
23/10/2019,13520,13429,26949,433371,VND,Tu Son,
24/10/2019,13580,13459,27039,487308,VND,Hai Duong,
25/10/2019,13641,13490,27131,142692,VND,Chi Linh,
28/10/2019,13580,13490,27070,215976,VND,Hung Yen,
29/10/2019,13490,13459,26949,214393,VND,Viet Tri,
30/10/2019,13550,13429,26979,215053,VND,Phu Tho,
31/10/2019,13641,13490,27131,143830,VND,Yen Bai,
1/11/2019,13611,13490,27101,295990,VND,Lao Cai,
4/11/2019,13520,13490,27010,108862,VND,Lai Chau,
5/11/2019,13580,13550,27130,511439,VND,Son La,
6/11/2019,13641,13580,27221,102875,VND,Dien Bien Phu,
7/11/2019,13641,13580,27221,374965,VND,Hoa Binh,
8/11/2019,13611,13580,27191,803025,VND,Ha Noi,
11/11/2019,13793,13641,27434,208274,VND,Ha Giang,
12/11/2019,13762,13641,27403,269154,VND,Cao Bang,
13/11/2019,13702,13520,27222,297260,VND,Tuyen Quang,
14/11/2019,13671,13520,27191,567899,VND,Lang Son,
15/11/2019,13611,13459,27070,537780,VND,Quang Ninh,
18/11/2019,13550,13308,26858,662247,VND,Bac Giang,
19/11/2019,13459,13338,26797,418015,VND,Hai Phong,
20/11/2019,13550,13399,26949,372145,VND,Nam Dinh,
21/11/2019,13520,13338,26858,360302,VND,Thai Binh,
22/11/2019,13459,13217,26676,479918,VND,Ninh Binh,
25/11/2019,13217,13035,26252,177149,VND,Thanh Hoa,
26/11/2019,13217,13095,26312,288584,VND,Sam Son,
27/11/2019,13277,13217,26494,279051,VND,Nghe An,
28/11/2019,13217,13035,26252,160424,VND,Vinh,
29/11/2019,13217,13065,26282,187771,VND,Ha Tinh,
2/12/2019,13277,13156,26433,309714,VND,Quang Binh,
3/12/2019,13247,13095,26342,378132,VND,Dong Hoi,
4/12/2019,13035,13035,26070,225081,VND,Quang Tri,
5/12/2019,13277,13156,26433,190179,VND,Dong Ha,
6/12/2019,13156,13095,26251,136441,VND,Hue,
9/12/2019,13156,12671,25827,151880,VND,Quang Nam,
10/12/2019,13035,12610,25645,150280,VND,Tam Ky,
11/12/2019,12853,12610,25463,273756,VND,Hoi An,
12/12/2019,12792,12610,25402,239151,VND,Quang Ngai,
13/12/2019,12671,12610,25281,159434,VND,Quang Ngai,
16/12/2019,12732,12610,25342,97597,VND,Binh Dinh,
17/12/2019,12732,12610,25342,236776,VND,Quy Nhon,
18/12/2019,12610,12580,25190,393983,VND,Phu Yen,
19/12/2019,12732,12610,25342,633151,VND,Tuy Hoa,
20/12/2019,12671,12671,25342,344632,VND,Khanh Hoa,
23/12/2019,12732,12701,25433,373646,VND,Nha Trang,
24/12/2019,12732,12701,25433,135600,VND,Cam Ranh,
25/12/2019,12701,12701,25402,374817,VND,Dak Lak,
26/12/2019,12792,12732,25524,265509,VND,Buon Ma Thuot,
27/12/2019,12883,12762,25645,79849,VND,Dak Nong,
30/12/2019,12792,12732,25524,122668,VND,Gia Lai,
31/12/2019,12823,12732,25555,77259,VND,Pleiku,
2/1/2020,12792,12732,25524,214624,VND,Kon Tum,
3/1/2020,12914,12914,25828,163574,VND,Kon Tum,
6/1/2020,12974,12732,25706,185792,VND,Gia Lai,
7/1/2020,12823,12762,25585,107312,VND,An Giang,
8/1/2020,12853,12671,25524,169693,VND,Long Xuyen,
9/1/2020,12671,12671,25342,313062,VND,Can Tho,
10/1/2020,12792,12792,25584,220991,VND,Rach Gia,
13/01/2020,13035,12974,26009,162403,VND,Kien Giang,
14/01/2020,13065,13065,26130,373167,VND,Ha Tien,
15/01/2020,13156,12792,25948,76451,VND,Ca Mau,
16/01/2020,13186,13186,26372,632309,VND,Ca Mau,
17/01/2020,13429,13065,26494,62398,VND,Bac Lieu,
20/01/2020,13065,12156,25221,128656,VND,Soc Trang,
21/01/2020,12671,12671,25342,202748,VND,Soc Trang,
22/01/2020,12853,12853,25706,74340,VND,Vinh Long,
30/01/2020,12883,12792,25675,169891,VND,Vinh Long,
31/01/2020,12792,12125,24917,147608,VND,Tra Vinh,
3/2/2020,11883,11822,23705,285698,VND,Ben Tre,
4/2/2020,12732,12429,25161,24082,VND,Ben Tre,
5/2/2020,12641,12641,25282,47025,VND,Tien Giang,
6/2/2020,12762,12671,25433,127748,VND,My Tho,
7/2/2020,12762,12610,25372,129365,VND,Long An,
10/2/2020,12792,12550,25342,118512,VND,Tan An,
11/2/2020,12671,12610,25281,71173,VND,Dong Nai,
12/2/2020,12732,12732,25464,148647,VND,Bien Hoa,
13/02/2020,12762,12701,25463,187623,VND,Binh Duong,
14/02/2020,12762,12762,25524,486384,VND,Thu Dau Mot,
17/02/2020,13277,13035,26312,341878,VND,Di An,
18/02/2020,13217,13035,26252,183087,VND,Tay Ninh,
19/02/2020,13156,12914,26070,205816,VND,Tay Ninh,
20/02/2020,12974,12944,25918,240025,VND,Binh Phuoc,
21/02/2020,12944,12853,25797,148944,VND,Dong Xoai,
24/02/2020,12429,12277,24706,266367,VND,Phu Quoc,
25/02/2020,11944,11944,23888,44980,VND,Vung Tau,
26/02/2020,12671,12429,25100,69128,VND,Ba Ria - Vung Tau,
27/02/2020,12580,12429,25009,447177,VND,Ho Chi Minh,
28/02/2020,12914,12732,25646,258152,VND,Thu Duc,
2/3/2020,13005,12792,25797,163690,VND,Tra Vinh,
3/3/2020,13035,12944,25979,419500,VND,Ben Tre,
4/3/2020,13186,12944,26130,1107923,VND,Ben Tre,
5/3/2020,13520,13277,26797,512346,VND,Tien Giang,
6/3/2020,13277,13126,26403,384581,VND,My Tho,
9/3/2020,12429,12429,24858,723737,VND,Long An,
10/3/2020,11731,11731,23462,399707,VND,Tan An,
11/3/2020,12732,11944,24676,254210,VND,Dong Nai,
12/3/2020,12307,11853,24160,1006945,VND,Bien Hoa,
13/03/2020,11459,11459,22918,464496,VND,Binh Duong,
16/03/2020,11913,11913,23826,930114,VND,Thu Dau Mot,
17/03/2020,12307,11913,24220,444720,VND,Di An,
18/03/2020,12732,12641,25373,920547,VND,Tay Ninh,
19/03/2020,12883,12610,25493,830390,VND,Tay Ninh,
20/03/2020,12641,12641,25282,1755374,VND,Binh Phuoc,
23/03/2020,13277,12429,25706,1260149,VND,Dong Xoai,
24/03/2020,13035,12732,25767,2333961,VND,Phu Quoc,
25/03/2020,13065,13065,26130,411978,VND,Vung Tau,
26/03/2020,13277,12429,25706,193792,VND,Ba Ria - Vung Tau,
27/03/2020,12004,11974,23978,162997,VND,Ho Chi Minh,
30/03/2020,11216,11155,22371,274333,VND,Thu Duc,
31/03/2020,11155,10398,21553,201907,VND,Ha Long,
1/4/2020,9670,9670,19340,472925,VND,Mong Cai,
3/4/2020,9822,9822,19644,167302,VND,Cam Pha,
6/4/2020,10307,10155,20462,652366,VND,Uong Bi,
7/4/2020,10610,10246,20856,330414,VND,Bac Kan,
8/4/2020,10004,10004,20008,86282,VND,Pho Yen,
9/4/2020,10579,10428,21007,276989,VND,Thai Nguyen,
10/4/2020,10549,10307,20856,142956,VND,Song Cong,
13/04/2020,10519,10428,20947,337226,VND,Bac Ninh,
14/04/2020,10610,10428,21038,197453,VND,Tu Son,
15/04/2020,10519,10519,21038,325598,VND,Hai Duong,
16/04/2020,11095,10792,21887,121580,VND,Chi Linh,
17/04/2020,10974,10974,21948,223531,VND,Hung Yen,
20/04/2020,11216,11095,22311,208620,VND,Viet Tri,
21/04/2020,11064,10367,21431,257476,VND,Phu Tho,
22/04/2020,10307,10307,20614,54761,VND,Yen Bai,
23/04/2020,11034,10610,21644,52254,VND,Lao Cai,
24/04/2020,10943,10731,21674,56542,VND,Lai Chau,
27/04/2020,10731,10549,21280,48097,VND,Son La,
28/04/2020,10731,10428,21159,57087,VND,Dien Bien Phu,
29/04/2020,10610,10428,21038,145216,VND,Hoa Binh,
4/5/2020,10428,10428,20856,123180,VND,Ha Noi,
5/5/2020,10670,10549,21219,55668,VND,Ha Giang,
6/5/2020,10731,10670,21401,168159,VND,Cao Bang,
7/5/2020,11034,10883,21917,141406,VND,Tuyen Quang,
8/5/2020,11034,10943,21977,277368,VND,Lang Son,
11/5/2020,10974,10974,21948,227011,VND,Quang Ninh,
12/5/2020,11398,11246,22644,582942,VND,Bac Giang,
13/05/2020,12186,12035,24221,572056,VND,Hai Phong,
14/05/2020,13641,13005,26646,1075973,VND,Nam Dinh,
15/05/2020,12792,12610,25402,558349,VND,Thai Binh,
18/05/2020,12732,12671,25403,168588,VND,Ninh Binh,
19/05/2020,13277,13035,26312,512759,VND,Thanh Hoa,
20/05/2020,13338,13095,26433,224949,VND,Sam Son,
21/05/2020,13277,13095,26372,266433,VND,Nghe An,
22/05/2020,13308,12732,26040,274911,VND,Vinh,
25/05/2020,12732,12610,25342,128573,VND,Ha Tinh,
26/05/2020,12732,12550,25282,392647,VND,Quang Binh,
27/05/2020,12974,12671,25645,123592,VND,Dong Hoi,
28/05/2020,12732,12489,25221,145529,VND,Quang Tri,
29/05/2020,12489,12429,24918,203408,VND,Dong Ha,
1/6/2020,12610,12610,25220,248140,VND,Hue,
2/6/2020,12914,12732,25646,207037,VND,Quang Nam,
3/6/2020,12732,12732,25464,901562,VND,Tam Ky,
4/6/2020,13338,13277,26615,516651,VND,Hoi An,
5/6/2020,13277,13217,26494,533723,VND,Quang Ngai,
8/6/2020,13156,13156,26312,219358,VND,Quang Ngai,
9/6/2020,13217,13035,26252,70579,VND,Binh Dinh,
10/6/2020,13126,13126,26252,209032,VND,Quy Nhon,
11/6/2020,13338,12489,25827,208670,VND,Phu Yen,
12/6/2020,11701,11701,23402,246310,VND,Tuy Hoa,
15/06/2020,12732,12307,25039,136325,VND,Khanh Hoa,
16/06/2020,12307,12307,24614,111930,VND,Nha Trang,
17/06/2020,12732,12459,25191,32494,VND,Cam Ranh,
18/06/2020,12368,12368,24736,33220,VND,Dak Lak,
19/06/2020,12550,12398,24948,135418,VND,Buon Ma Thuot,
22/06/2020,12732,12429,25161,202006,VND,Dak Nong,
23/06/2020,12974,12580,25554,239316,VND,Gia Lai,
24/06/2020,12671,12671,25342,245072,VND,Pleiku,
25/06/2020,12641,12489,25130,123724,VND,Kon Tum,
26/06/2020,12550,12550,25100,98553,VND,Kon Tum,
29/06/2020,12732,12307,25039,149257,VND,Gia Lai,
30/06/2020,12641,12489,25130,58423,VND,An Giang,
1/7/2020,12489,12429,24918,37953,VND,Long Xuyen,
2/7/2020,12429,12429,24858,55157,VND,Can Tho,
3/7/2020,12610,12489,25099,37492,VND,Rach Gia,
6/7/2020,12580,12520,25100,90917,VND,Kien Giang,
7/7/2020,12732,12701,25433,140795,VND,Ha Tien,
8/7/2020,12701,12701,25402,130684,VND,Ca Mau,
9/7/2020,13035,13035,26070,354562,VND,Ca Mau,
10/7/2020,13035,13035,26070,111469,VND,Bac Lieu,
13/07/2020,13217,13035,26252,137018,VND,Soc Trang,
14/07/2020,13217,13005,26222,56790,VND,Soc Trang,
15/07/2020,13186,13095,26281,37574,VND,Vinh Long,
16/07/2020,13126,13005,26131,192043,VND,Vinh Long,
17/07/2020,13247,13247,26494,104129,VND,Tra Vinh,
20/07/2020,13338,13247,26585,50720,VND,Ben Tre,
21/07/2020,13247,12944,26191,118182,VND,Ben Tre,
22/07/2020,13217,12792,26009,97910,VND,Tien Giang,
23/07/2020,13095,12732,25827,110990,VND,My Tho,
24/07/2020,12853,12429,25282,255810,VND,Long An,
27/07/2020,11762,11762,23524,167054,VND,Tan An,
28/07/2020,11822,11822,23644,348756,VND,Dong Nai,
29/07/2020,12247,11944,24191,107592,VND,Bien Hoa,
30/07/2020,12125,12125,24250,27826,VND,Binh Duong,
31/07/2020,12004,12004,24008,58043,VND,Ha Long,
3/8/2020,12550,12489,25039,38432,VND,Mong Cai,
4/8/2020,12732,12520,25252,124054,VND,Cam Pha,
5/8/2020,13035,12610,25645,43545,VND,Uong Bi,
6/8/2020,12732,12580,25312,85704,VND,Bac Kan,
7/8/2020,12853,12610,25463,36782,VND,Pho Yen,
10/8/2020,12671,12671,25342,104904,VND,Thai Nguyen,
11/8/2020,12792,12671,25463,62678,VND,Song Cong,
12/8/2020,12792,12732,25524,68699,VND,Bac Ninh,
13/08/2020,12914,12823,25737,21195,VND,Tu Son,
14/08/2020,12792,12762,25554,43199,VND,Hai Duong,
17/08/2020,12610,12610,25220,51264,VND,Chi Linh,
18/08/2020,12914,12641,25555,116879,VND,Hung Yen,
19/08/2020,12914,12671,25585,41500,VND,Viet Tri,
20/08/2020,12671,12671,25342,248058,VND,Phu Tho,
21/08/2020,13095,13095,26190,361852,VND,Yen Bai,
24/08/2020,13702,13520,27222,754400,VND,Lao Cai,
25/08/2020,13580,13459,27039,464727,VND,Lai Chau,
26/08/2020,13641,13520,27161,247547,VND,Son La,
27/08/2020,13580,13338,26918,211968,VND,Dien Bien Phu,
28/08/2020,13580,13429,27009,440365,VND,Hoa Binh,
31/08/2020,13580,13520,27100,354017,VND,Ha Noi,
1/9/2020,13762,13702,27464,933363,VND,Ha Giang,
3/9/2020,14187,13944,28131,618768,VND,Cao Bang,
4/9/2020,14126,13944,28070,624095,VND,Tuyen Quang,
7/9/2020,14035,13823,27858,2298647,VND,Lang Son,
8/9/2020,13823,13823,27646,1805583,VND,Quang Ninh,
9/9/2020,13823,13732,27555,2204432,VND,Bac Giang,
10/9/2020,13975,13944,27919,2401110,VND,Hai Phong,
11/9/2020,14066,13944,28010,1887460,VND,Nam Dinh,
14/09/2020,14066,13944,28010,1710427,VND,Thai Binh,
15/09/2020,13944,13853,27797,2105614,VND,Ninh Binh,
16/09/2020,13944,13853,27797,2160771,VND,Thanh Hoa,
17/09/2020,13914,13853,27767,2193925,VND,Sam Son,
18/09/2020,13914,13853,27767,4691147,VND,Nghe An,
21/09/2020,14551,14338,28889,2384236,VND,Vinh,
22/09/2020,14308,14308,28616,4724069,VND,Ha Tinh,
23/09/2020,14490,14369,28859,2695434,VND,Quang Binh,
24/09/2020,14369,14338,28707,2355602,VND,Dong Hoi,
25/09/2020,14429,14247,28676,2386859,VND,Quang Tri,
28/09/2020,14247,14247,28494,1660861,VND,Dong Ha,
29/09/2020,14429,14126,28555,1849507,VND,Hue,
30/09/2020,14247,14156,28403,4689596,VND,Quang Nam,
1/10/2020,14247,14247,28494,7272308,VND,Tam Ky,
2/10/2020,15096,14611,29707,5508407,VND,Hoi An,
5/10/2020,15157,15126,30283,5889706,VND,Quang Ngai,
6/10/2020,15217,15066,30283,5794764,VND,Quang Ngai,
7/10/2020,15126,14975,30101,4526632,VND,Binh Dinh,
8/10/2020,15096,14823,29919,3156565,VND,Quy Nhon,
9/10/2020,14914,14854,29768,5736935,VND,Phu Yen,
12/10/2020,15217,15036,30253,3341797,VND,Tuy Hoa,
13/10/2020,15036,14884,29920,3192507,VND,Khanh Hoa,
14/10/2020,15126,15036,30162,5403981,VND,Nha Trang,
15/10/2020,15187,15036,30223,4837253,VND,Cam Ranh,
16/10/2020,15005,14975,29980,5969093,VND,Dak Lak,
19/10/2020,15187,15096,30283,6076586,VND,Buon Ma Thuot,
20/10/2020,15521,15399,30920,5502007,VND,Dak Nong,
21/10/2020,15551,15157,30708,6648988,VND,Gia Lai,
22/10/2020,15157,14854,30011,3336518,VND,Pleiku,
23/10/2020,15278,14945,30223,3592477,VND,Kon Tum,
26/10/2020,14945,14551,29496,3218815,VND,Kon Tum,
27/10/2020,14490,14187,28677,4435188,VND,Gia Lai,
28/10/2020,14278,13399,27677,3283770,VND,An Giang,
29/10/2020,13520,13520,27040,3215236,VND,Long Xuyen,
30/10/2020,13884,13580,27464,1509609,VND,Can Tho,
2/11/2020,13884,13884,27768,1765056,VND,Rach Gia,
3/11/2020,14066,13944,28010,2604155,VND,Kien Giang,
4/11/2020,14247,14156,28403,2969108,VND,Ha Tien,
5/11/2020,14338,14187,28525,1990632,VND,Ca Mau,
6/11/2020,14187,14126,28313,1519324,VND,Ca Mau,
9/11/2020,14278,14278,28556,6053791,VND,Bac Lieu,
10/11/2020,14975,14551,29526,2652120,VND,Soc Trang,
11/11/2020,14672,14551,29223,3107660,VND,Soc Trang,
12/11/2020,14672,14551,29223,2068931,VND,Vinh Long,
13/11/2020,14763,14641,29404,2517873,VND,Vinh Long,
16/11/2020,14854,14672,29526,2667146,VND,Tra Vinh,
17/11/2020,14793,14641,29434,2801328,VND,Ben Tre,
18/11/2020,14975,14884,29859,3395238,VND,Ben Tre,
19/11/2020,15036,14945,29981,3162404,VND,Tien Giang,
20/11/2020,14975,14884,29859,2334473,VND,My Tho,
23/11/2020,14945,14763,29708,2981214,VND,Long An,
24/11/2020,15096,14975,30071,9863366,VND,Tan An,
25/11/2020,15460,15217,30677,3230971,VND,Dong Nai,
26/11/2020,15157,14975,30132,3292116,VND,Bien Hoa,
27/11/2020,15066,15036,30102,6240985,VND,Binh Duong,
30/11/2020,16445,15926,32371,4128069,VND,Thu Dau Mot,
1/12/2020,16296,16296,32592,3598275,VND,Di An,
2/12/2020,16482,16111,32593,5678193,VND,Tay Ninh,
3/12/2020,16185,16000,32185,3340925,VND,Tay Ninh,
4/12/2020,16074,15963,32037,3396275,VND,Ha Long,
7/12/2020,16222,16185,32407,2400812,VND,Mong Cai,
8/12/2020,16370,16259,32629,2651507,VND,Cam Pha,
9/12/2020,16333,16296,32629,4790285,VND,Uong Bi,
10/12/2020,16667,16445,33112,2671028,VND,Bac Kan,
11/12/2020,16407,16333,32740,2410627,VND,Pho Yen,
14/12/2020,16556,16445,33001,2582549,VND,Thai Nguyen,
15/12/2020,16630,16445,33075,1454584,VND,Song Cong,
16/12/2020,16556,16482,33038,3526347,VND,Bac Ninh,
17/12/2020,16889,16630,33519,4127273,VND,Tu Son,
18/12/2020,17741,17445,35186,4689885,VND,Hai Duong,
21/12/2020,19111,19037,38148,5701953,VND,Chi Linh,
22/12/2020,19926,19926,39852,4890185,VND,Hung Yen,
23/12/2020,20296,19259,39555,3470241,VND,Viet Tri,
24/12/2020,19407,18259,37666,3760910,VND,Phu Tho,
25/12/2020,18963,18593,37556,5869960,VND,Yen Bai,
28/12/2020,20370,19593,39963,2924437,VND,Lao Cai,
29/12/2020,19630,19482,39112,2110670,VND,Lai Chau,
30/12/2020,19630,19482,39112,2579417,VND,Son La,
31/12/2020,19852,19519,39371,2408440,VND,Dien Bien Phu,
4/1/2021,20482,20148,40630,5023483,VND,Hoa Binh,
5/1/2021,20667,20445,41112,3671324,VND,Ha Noi,
6/1/2021,20704,20445,41149,5063713,VND,Ha Giang,
7/1/2021,20741,20593,41334,5231113,VND,Cao Bang,
8/1/2021,21111,20815,41926,5543503,VND,Tuyen Quang,
11/1/2021,21111,20741,41852,4183244,VND,Lang Son,
12/1/2021,21000,20222,41222,3425354,VND,Quang Ninh,
13/01/2021,20741,20407,41148,6216208,VND,Bac Giang,
14/01/2021,20445,20185,40630,2968109,VND,Hai Phong,
15/01/2021,20741,20667,41408,11539121,VND,Nam Dinh,
18/01/2021,21852,21259,43111,5969023,VND,Thai Binh,
19/01/2021,21482,19852,41334,6632278,VND,Ninh Binh,
20/01/2021,20741,19259,40000,4936274,VND,Thanh Hoa,
21/01/2021,20741,20445,41186,4315949,VND,Sam Son,
22/01/2021,20963,20482,41445,3706424,VND,Nghe An,
25/01/2021,20519,20148,40667,2684069,VND,Vinh,
26/01/2021,20148,19259,39407,3661469,VND,Ha Tinh,
27/01/2021,19259,18445,37704,3833864,VND,Quang Binh,
28/01/2021,17296,17296,34592,6201898,VND,Dong Hoi,
29/01/2021,16296,16296,32592,5096788,VND,Quang Tri,
1/2/2021,18815,17741,36556,1862459,VND,Dong Ha,
2/2/2021,18037,17778,35815,2222234,VND,Hue,
3/2/2021,19111,18963,38074,2564189,VND,Quang Nam,
4/2/2021,19926,18889,38815,1510650,VND,Tam Ky,
5/2/2021,19407,19407,38814,1508760,VND,Hoi An,
8/2/2021,19778,18519,38297,2880764,VND,Quang Ngai,
9/2/2021,19556,19185,38741,2064959,VND,Quang Ngai,
17/02/2021,20000,19926,39926,2307554,VND,Binh Dinh,
18/02/2021,20593,20296,40889,1999484,VND,Quy Nhon,
19/02/2021,20519,20370,40889,2386799,VND,Phu Yen,
22/02/2021,20704,20556,41260,5384203,VND,Tuy Hoa,
23/02/2021,20778,20445,41223,4000724,VND,Khanh Hoa,
24/02/2021,20741,19852,40593,2578229,VND,Nha Trang,
25/02/2021,20370,20000,40370,2348324,VND,Cam Ranh,
26/02/2021,20000,19926,39926,1899179,VND,Dak Lak,
1/3/2021,20741,20593,41334,4958279,VND,Buon Ma Thuot,
2/3/2021,21111,20852,41963,23205006,VND,Dak Nong,
3/3/2021,22148,22000,44148,7950957,VND,Gia Lai,
4/3/2021,22074,21111,43185,5443333,VND,Pleiku,
5/3/2021,20889,20519,41408,8327337,VND,Kon Tum,
8/3/2021,21333,21037,42370,6343918,VND,Kon Tum,
9/3/2021,20889,20593,41482,4545584,VND,Gia Lai,
10/3/2021,21074,20741,41815,3466394,VND,An Giang,
11/3/2021,21296,21111,42407,6761878,VND,Long Xuyen,
12/3/2021,21222,21148,42370,7861722,VND,Can Tho,
15/03/2021,21259,21222,42481,6206218,VND,Rach Gia,
16/03/2021,21333,20889,42222,4065524,VND,Kien Giang,
17/03/2021,21037,20926,41963,4935599,VND,Ha Tien,
18/03/2021,21482,21259,42741,7805563,VND,Ca Mau,
19/03/2021,21482,21222,42704,9378447,VND,Ca Mau,
22/03/2021,21407,21259,42666,4686794,VND,Bac Lieu,
23/03/2021,21259,20741,42000,5910163,VND,Soc Trang,
24/03/2021,20593,19926,40519,9003282,VND,Soc Trang,
25/03/2021,20148,19815,39963,7048888,VND,Vinh Long,
26/03/2021,19815,19037,38852,6806428,VND,Vinh Long,
29/03/2021,20074,19889,39963,2922074,VND,Tra Vinh,
30/03/2021,20370,20296,40666,3526064,VND,Ben Tre,
31/03/2021,20593,20482,41075,2932469,VND,Ben Tre,
1/4/2021,20630,20556,41186,5575093,VND,Tien Giang,
2/4/2021,21111,20889,42000,4316354,VND,My Tho,
5/4/2021,21222,20926,42148,4682879,VND,Long An,
6/4/2021,21000,20741,41741,7692973,VND,Tan An,
7/4/2021,20852,20815,41667,139361,VND,Dong Nai,
8/4/2021,21482,21259,42741,5710768,VND,Bien Hoa,
9/4/2021,21445,21185,42630,3830084,VND,Binh Duong,
12/4/2021,21556,21333,42889,9997152,VND,Thu Dau Mot,
13/04/2021,21741,21704,43445,164344,VND,Di An,
14/04/2021,21815,21482,43297,5685388,VND,Tay Ninh,
15/04/2021,21963,21333,43296,8002662,VND,Tay Ninh,
16/04/2021,21037,20333,41370,123026,VND,Binh Phuoc,
19/04/2021,20741,20296,41037,5769223,VND,Dong Xoai,
20/04/2021,21074,20482,41556,6167473,VND,Phu Quoc,
22/04/2021,20593,20000,40593,6107398,VND,Vung Tau,
23/04/2021,20370,19852,40222,5365168,VND,Ba Ria - Vung Tau,
26/04/2021,20741,20074,40815,3329909,VND,Ho Chi Minh,
27/04/2021,20111,19926,40037,2650994,VND,Ha Long,
28/04/2021,20000,19926,39926,3245129,VND,Mong Cai,
29/04/2021,20333,20148,40481,8127132,VND,Cam Pha,
4/5/2021,19963,19926,39889,5683903,VND,Uong Bi,
5/5/2021,20889,20778,41667,7374778,VND,Bac Kan,
6/5/2021,21074,20815,41889,5039413,VND,Pho Yen,
7/5/2021,20667,20667,41334,181089,VND,Thai Nguyen,
10/5/2021,21556,21482,43038,192658,VND,Song Cong,
11/5/2021,23704,22963,46667,12771,VND,Bac Ninh,
12/5/2021,22815,22667,45482,103306,VND,Tu Son,
13/05/2021,23704,23333,47037,108971,VND,Hai Duong,
14/05/2021,23556,23333,46889,9819492,VND,Chi Linh,
17/05/2021,23778,23778,47556,9249927,VND,Hung Yen,
18/05/2021,24148,23407,47555,8947932,VND,Viet Tri,
19/05/2021,23778,23778,47556,8167362,VND,Phu Tho,
20/05/2021,24445,24333,48778,8469492,VND,Yen Bai,
21/05/2021,24445,24185,48630,8380257,VND,Lao Cai,
24/05/2021,24445,24148,48593,9989997,VND,Lai Chau,
25/05/2021,24889,24852,49741,8136852,VND,Son La,
26/05/2021,26037,26000,52037,10689971,VND,Dien Bien Phu,
27/05/2021,26519,25556,52075,10252031,VND,Hoa Binh,
28/05/2021,26000,25815,51815,8985597,VND,Ha Noi,
31/05/2021,26741,26741,53482,5190613,VND,Ha Giang,
1/6/2021,28593,27741,56334,8162907,VND,Cao Bang,
2/6/2021,27407,27111,54518,6829108,VND,Tuyen Quang,
3/6/2021,27741,27556,55297,7211833,VND,Lang Son,
4/6/2021,28148,27778,55926,6475138,VND,Quang Ninh,
7/6/2021,28148,27037,55185,6905383,VND,Bac Giang,
8/6/2021,27407,25630,53037,6890128,VND,Hai Phong,
9/6/2021,25926,25185,51111,7907622,VND,Nam Dinh,
10/6/2021,27037,26111,53148,4432994,VND,Thai Binh,
11/6/2021,26296,26111,52407,7601983,VND,Ninh Binh,
14/06/2021,27407,26519,53926,4440959,VND,Thanh Hoa,
15/06/2021,26889,26296,53185,4899824,VND,Sam Son,
16/06/2021,26296,25926,52222,8091627,VND,Nghe An,
17/06/2021,25926,25704,51630,5337358,VND,Vinh,
18/06/2021,26519,26259,52778,3688469,VND,Ha Tinh,
21/06/2021,26556,26074,52630,4973669,VND,Quang Binh,
22/06/2021,26111,26074,52185,4948019,VND,Dong Hoi,
23/06/2021,26593,26333,52926,3523229,VND,Quang Tri,
24/06/2021,26667,26259,52926,3879359,VND,Dong Ha,
25/06/2021,26407,26111,52518,3750434,VND,Hue,
28/06/2021,26889,26519,53408,14961370,VND,Quang Nam,
29/06/2021,28148,27333,55481,6597178,VND,Tam Ky,
30/06/2021,27556,27185,54741,3822929,VND,Hoi An,
1/7/2021,27259,26778,54037,7345888,VND,Quang Ngai,
2/7/2021,27852,27556,55408,6872983,VND,Quang Ngai,
5/7/2021,28185,28037,56222,11315696,VND,Binh Dinh,
6/7/2021,29111,27074,56185,10830236,VND,Quy Nhon,
7/7/2021,27333,26370,53703,7696888,VND,Phu Yen,
8/7/2021,27741,27556,55297,7795708,VND,Tuy Hoa,
9/7/2021,27704,26667,54371,6424648,VND,Khanh Hoa,
12/7/2021,27407,25519,52926,10198301,VND,Nha Trang,
13/07/2021,26296,25185,51481,4405049,VND,Cam Ranh,
14/07/2021,25704,24370,50074,7037143,VND,Dak Lak,
15/07/2021,24445,24148,48593,4417469,VND,Buon Ma Thuot,
16/07/2021,25407,25037,50444,2605904,VND,Dak Nong,
19/07/2021,24593,23370,47963,7023508,VND,Gia Lai,
20/07/2021,23556,23259,46815,10327496,VND,Pleiku,
21/07/2021,24593,24370,48963,7763713,VND,Kon Tum,
22/07/2021,24519,24222,48741,8342862,VND,Kon Tum,
23/07/2021,24667,24445,49112,8495817,VND,Gia Lai,
26/07/2021,24074,24037,48111,9562587,VND,An Giang,
27/07/2021,24741,24593,49334,12803261,VND,Long Xuyen,
28/07/2021,25111,25037,50148,7629388,VND,Can Tho,
29/07/2021,25445,25445,50890,10020911,VND,Rach Gia,
30/07/2021,25926,25704,51630,7371943,VND,Kien Giang,
2/8/2021,25704,25519,51223,8896902,VND,Ha Tien,
3/8/2021,25556,25259,50815,5293483,VND,Ca Mau,
4/8/2021,25704,25667,51371,12723746,VND,Ca Mau,
5/8/2021,26296,26000,52296,6587053,VND,Bac Lieu,
6/8/2021,26741,26259,53000,5220853,VND,Soc Trang,
9/8/2021,26148,25889,52037,4903469,VND,Soc Trang,
10/8/2021,26815,26222,53037,4608359,VND,Vinh Long,
11/8/2021,26815,26519,53334,18305588,VND,Vinh Long,
12/8/2021,27333,26963,54296,4193774,VND,Tra Vinh,
13/08/2021,26370,26370,52740,4692464,VND,Ben Tre,
16/08/2021,26963,26667,53630,9185802,VND,Ben Tre,
17/08/2021,28037,27407,55444,6505783,VND,Tien Giang,
18/08/2021,27630,27407,55037,3988034,VND,My Tho,
19/08/2021,27445,27000,54445,4324049,VND,Long An,
20/08/2021,27185,25333,52518,8697372,VND,Tan An,
23/08/2021,25630,25037,50667,6725158,VND,Dong Nai,
24/08/2021,25000,24889,49889,4214564,VND,Bien Hoa,
25/08/2021,25222,24889,50111,4135859,VND,Binh Duong,
26/08/2021,25926,25259,51185,4661009,VND,Thu Dau Mot,
27/08/2021,24926,24778,49704,3223124,VND,Di An,
30/08/2021,25407,25148,50555,2990114,VND,Tay Ninh,
31/08/2021,25704,25185,50889,2584574,VND,Tay Ninh,
1/9/2021,25185,25111,50296,3184514,VND,Binh Phuoc,
6/9/2021,25815,25445,51260,6544528,VND,Dong Xoai,
7/9/2021,25852,25778,51630,15282670,VND,Phu Quoc,
8/9/2021,27037,26667,53704,8738142,VND,Vung Tau,
9/9/2021,26741,26556,53297,16913200,VND,Ba Ria - Vung Tau,
10/9/2021,28148,27704,55852,10573331,VND,Ho Chi Minh,
13/09/2021,27778,27630,55408,9408552,VND,Thu Duc,
14/09/2021,27852,27815,55667,8271447,VND,Ha Long,
15/09/2021,27778,27407,55185,9387222,VND,Mong Cai,
16/09/2021,28519,28296,56815,7055233,VND,Cam Pha,
17/09/2021,28741,28593,57334,15977244,VND,Uong Bi,
20/09/2021,30370,29259,59629,12070481,VND,Bac Kan,
21/09/2021,29333,29259,58592,8930787,VND,Pho Yen,
22/09/2021,29852,29111,58963,5632198,VND,Thai Nguyen,
23/09/2021,29963,29333,59296,24261516,VND,Song Cong,
24/09/2021,30889,30593,61482,12303221,VND,Bac Ninh,
27/09/2021,30889,29630,60519,8347182,VND,Tu Son,
28/09/2021,29259,28963,58222,7344673,VND,Hai Duong,
29/09/2021,29852,29852,59704,10944446,VND,Chi Linh,
30/09/2021,30445,30445,60890,8542662,VND,Hung Yen,
1/10/2021,31000,30704,61704,20131192,VND,Viet Tri,
4/10/2021,31704,30741,62445,17863598,VND,Phu Tho,
5/10/2021,31333,30815,62148,12540281,VND,Yen Bai,
6/10/2021,31482,31037,62519,11344856,VND,Lao Cai,
7/10/2021,31445,30963,62408,6320023,VND,Lai Chau,
8/10/2021,31630,30963,62593,4229954,VND,Son La,
11/10/2021,31185,31148,62333,6698158,VND,Dien Bien Phu,
12/10/2021,32000,31630,63630,2522609,VND,Hoa Binh,
13/10/2021,31482,31333,62815,3116609,VND,Ha Noi,
14/10/2021,31259,31111,62370,4765364,VND,Ha Giang,
15/10/2021,31556,31519,63075,10991426,VND,Cao Bang,
18/10/2021,32445,32333,64778,7263943,VND,Tuyen Quang,
19/10/2021,32519,32074,64593,2372354,VND,Lang Son,
20/10/2021,32963,32296,65259,4655339,VND,Quang Ninh,
21/10/2021,32556,32370,64926,4750514,VND,Bac Giang,
22/10/2021,32407,31926,64333,3521339,VND,Hai Phong,
25/10/2021,32000,31111,63111,4909139,VND,Nam Dinh,
26/10/2021,31037,30889,61926,2848094,VND,Thai Binh,
27/10/2021,31815,31482,63297,2383559,VND,Ninh Binh,
28/10/2021,32222,32222,64444,7245043,VND,Thanh Hoa,
29/10/2021,32889,32556,65445,6528058,VND,Sam Son,
1/11/2021,33222,31778,65000,4281524,VND,Nghe An,
2/11/2021,32222,32148,64370,6431128,VND,Vinh,
3/11/2021,32445,32370,64815,6609733,VND,Ha Tinh,
4/11/2021,32741,32333,65074,2700944,VND,Quang Binh,
5/11/2021,32667,32000,64667,3890564,VND,Dong Hoi,
8/11/2021,32482,32370,64852,6152893,VND,Quang Tri,
9/11/2021,32593,32000,64593,3165884,VND,Dong Ha,
10/11/2021,32000,31889,63889,2523419,VND,Hue,
11/11/2021,32593,31704,64297,3262814,VND,Quang Nam,
12/11/2021,31926,31630,63556,1873934,VND,Tam Ky,
15/11/2021,32741,32222,64963,3382829,VND,Hoi An,
16/11/2021,32593,32370,64963,3420224,VND,Quang Ngai,
17/11/2021,32593,32000,64593,2122199,VND,Quang Ngai,
18/11/2021,31963,31815,63778,2978504,VND,Binh Dinh,
19/11/2021,31778,31741,63519,4260194,VND,Quy Nhon,
22/11/2021,32593,32222,64815,13823455,VND,Phu Yen,
23/11/2021,35185,34445,69630,10469786,VND,Tuy Hoa,
24/11/2021,36074,35333,71407,9857832,VND,Khanh Hoa,
25/11/2021,36667,35667,72334,5811343,VND,Nha Trang,
26/11/2021,36370,35185,71555,4480919,VND,Cam Ranh,
29/11/2021,34445,34445,68890,3253769,VND,Dak Lak,
30/11/2021,35482,32963,68445,8527272,VND,Buon Ma Thuot,
1/12/2021,33333,33185,66518,7398403,VND,Dak Nong,
2/12/2021,35593,35593,71186,7767898,VND,Gia Lai,
3/12/2021,36222,34815,71037,4892939,VND,Pleiku,
6/12/2021,34519,33333,67852,5817148,VND,Kon Tum,
7/12/2021,35111,34482,69593,3047894,VND,Kon Tum,
8/12/2021,35630,35630,71260,12401096,VND,Gia Lai,
9/12/2021,37852,37333,75185,3434939,VND,An Giang,
10/12/2021,37926,37630,75556,11043671,VND,Long Xuyen,
13/12/2021,38519,37037,75556,6321913,VND,Can Tho,
14/12/2021,37037,36667,73704,3158324,VND,Rach Gia,
15/12/2021,37482,36963,74445,6209593,VND,Kien Giang,
16/12/2021,39037,37926,76963,5421598,VND,Ha Tien,
17/12/2021,38074,37333,75407,5893828,VND,Ca Mau,
20/12/2021,39000,38700,77700,8238900,VND,Ca Mau,
21/12/2021,39500,38500,78000,3634600,VND,Bac Lieu,
22/12/2021,38500,37900,76400,5929700,VND,Soc Trang,
23/12/2021,38000,35700,73700,4598100,VND,Soc Trang,
24/12/2021,36600,36450,73050,7855000,VND,Vinh Long,
27/12/2021,39600,39200,78800,9038200,VND,Vinh Long,
28/12/2021,40500,40000,80500,8593600,VND,Tra Vinh,
29/12/2021,25926,25259,51185,5365300,VND,Ben Tre,
30/12/2021,24926,24778,49704,3226200,VND,Ben Tre,
31/12/2021,25407,25148,50555,3726100,VND,Tien Giang,
4/1/2022,25704,25185,50889,11034900,VND,My Tho,
5/1/2022,39900,39450,79350,3828100,VND,Long An,
6/1/2022,39550,39550,79100,5190400,VND,Tan An,
7/1/2022,41850,41000,82850,4150700,VND,Dong Nai,
10/1/2022,19556,19185,38741,4219100,VND,Bien Hoa,
11/1/2022,20000,19926,39926,4830300,VND,Binh Duong,
12/1/2022,20593,20296,40889,18620300,VND,Thu Dau Mot,
13/01/2022,20519,20370,40889,17622800,VND,Di An,
14/01/2022,20704,20556,41260,5566400,VND,Tay Ninh,
17/01/2022,20778,20445,41223,9068700,VND,Tay Ninh,
18/01/2022,39600,38750,78350,9953400,VND,Binh Phuoc,
19/01/2022,38600,38600,77200,6653400,VND,Dong Xoai,
20/01/2022,39300,39250,78550,7434600,VND,Phu Quoc,
21/01/2022,39650,39650,79300,8225000,VND,Vung Tau,
24/01/2022,40000,37200,77200,6820100,VND,Ba Ria - Vung Tau,
25/01/2022,37700,37700,75400,8957900,VND,Ho Chi Minh,
26/01/2022,40000,39200,79200,10946400,VND,Thu Duc,
27/01/2022,39400,39200,78600,7264800,VND,Ha Long,
28/01/2022,40150,40000,80150,15526500,VND,Mong Cai,
7/2/2022,42300,41300,83600,5806800,VND,Cam Pha,
8/2/2022,41850,41300,83150,5776900,VND,Uong Bi,
9/2/2022,41900,41400,83300,5316900,VND,Bac Kan,
10/2/2022,41800,40800,82600,3954300,VND,Pho Yen,
11/2/2022,41000,40800,81800,15984500,VND,Thai Nguyen,
14/02/2022,42000,40000,82000,7405700,VND,Song Cong,
15/02/2022,41000,40200,81200,3153900,VND,Bac Ninh,
16/02/2022,40950,40350,81300,2879600,VND,Tu Son,
17/02/2022,40400,40300,80700,3081100,VND,Hai Duong,
18/02/2022,40500,40500,81000,3759900,VND,Chi Linh,
21/02/2022,40500,40100,80600,3924200,VND,Hung Yen,
22/02/2022,40550,40400,80950,8309400,VND,Viet Tri,
23/02/2022,41500,41450,82950,16076300,VND,Phu Tho,
24/02/2022,42000,40300,82300,4957200,VND,Yen Bai,
25/02/2022,41700,41300,83000,10795200,VND,Lao Cai,
28/02/2022,41800,41000,82800,5548200,VND,Lai Chau,
1/3/2022,14410,13960,28370,11884800,VND,Son La,
2/3/2022,14149,13818,27967,8271600,VND,Dien Bien Phu,
3/3/2022,14670,14102,28772,4590700,VND,Hoa Binh,
4/3/2022,14244,14007,28251,5107000,VND,Ha Noi,
7/3/2022,14197,13724,27921,10005000,VND,Ha Giang,
8/3/2022,13960,13534,27494,5092700,VND,Cao Bang,
9/3/2022,14102,13629,27731,2653800,VND,Tuyen Quang,
10/3/2022,39800,38950,78750,2043100,VND,Lang Son,
11/3/2022,38700,38550,77250,2509400,VND,Quang Ninh,
14/03/2022,38500,38500,77000,2160600,VND,Bac Giang,
15/03/2022,39200,39100,78300,8713700,VND,Hai Phong,
16/03/2022,39950,39650,79600,2937800,VND,Nam Dinh,
17/03/2022,40050,39600,79650,3131300,VND,Thai Binh,
18/03/2022,39900,39450,79350,1622300,VND,Ninh Binh,
21/03/2022,39550,39550,79100,3849800,VND,Thanh Hoa,
22/03/2022,42200,41900,84100,6367200,VND,Sam Son,
23/03/2022,42450,41100,83550,4207000,VND,Nghe An,
24/03/2022,41600,41100,82700,2951000,VND,Vinh,
25/03/2022,41100,40500,81600,2187700,VND,Ha Tinh,
28/03/2022,40400,38500,78900,2993800,VND,Quang Binh,
29/03/2022,38800,38350,77150,4909800,VND,Dong Hoi,
30/03/2022,38850,38800,77650,5350100,VND,Quang Tri,
31/03/2022,10519,10428,20947,2433800,VND,Dong Ha,
1/4/2022,10610,10428,21038,11121000,VND,Hue,
4/4/2022,10519,10519,21038,6600400,VND,Quang Nam,
5/4/2022,11095,10792,21887,4682200,VND,Tam Ky,
6/4/2022,10974,10974,21948,6695600,VND,Hoi An,
7/4/2022,11216,11095,22311,8696600,VND,Quang Ngai,
8/4/2022,11064,10367,21431,3486300,VND,Quang Ngai,
1/6/2022,26889,26296,53185,13711,VND,Binh Dinh,
2/6/2022,26296,25926,52222,10517,VND,Quy Nhon,
3/6/2022,25926,25704,51630,2339,VND,Phu Yen,
4/6/2022,26519,26259,52778,12813,VND,Tuy Hoa,
5/6/2022,26556,26074,52630,3544,VND,Khanh Hoa,
6/6/2022,26111,26074,52185,12691,VND,Nha Trang,
7/6/2022,26593,26333,52926,9825,VND,Cam Ranh,
8/6/2022,26296,25926,52222,3330,VND,Dak Lak,
9/6/2022,25926,25704,51630,3950,VND,Buon Ma Thuot,
10/6/2022,26519,26259,52778,9141,VND,Dak Nong,
11/6/2022,13641,13520,27161,4499,VND,Gia Lai,
1/9/2022,13580,13338,26918,6880,VND,Pleiku,
2/9/2022,13580,13429,27009,2781,VND,Kon Tum,
3/9/2022,13580,13520,27100,12306,VND,Kon Tum,
4/9/2022,13762,13702,27464,12948,VND,Gia Lai,
5/9/2022,14187,13944,28131,13198,VND,An Giang,
6/9/2022,25926,25704,51630,7494,VND,Long Xuyen,
7/9/2022,26519,26259,52778,6068,VND,Can Tho,
8/9/2022,26519,26259,52778,2068,VND,Rach Gia,
9/9/2022,52535,42231,94766,7679,VND,Kien Giang,
10/9/2022,56508,53846,110354,1989,VND,Ha Tien,
11/9/2022,67163,65461,132624,4378,VND,Ca Mau,
12/9/2022,13777,12076,25853,6602,VND,Ca Mau,
1/1/2023,15522,15096,30618,5126,VND,Bac Lieu,
2/1/2023,15380,14339,29719,4834,VND,Soc Trang,
3/1/2023,14339,13582,27921,12135,VND,Soc Trang,
4/1/2023,14528,13960,28488,12649,VND,Vinh Long,
5/1/2023,14173,13889,28062,8606,VND,Vinh Long,
6/1/2023,14623,14055,28678,8592,VND,Tra Vinh,
7/1/2023,14102,13724,27826,2488,VND,Ben Tre,
8/1/2023,14410,13960,28370,7273,VND,Ben Tre,
9/1/2023,14149,13818,27967,18305588,VND,Tien Giang,
10/1/2023,14670,14102,28772,4193774,VND,My Tho,
11/1/2023,14244,14007,28251,4692464,VND,Long An,
12/1/2023,14197,13724,27921,9185802,VND,Tan An,
1/2/2023,13960,13534,27494,6505783,VND,Dong Nai,
2/2/2023,14102,13629,27731,3988034,VND,Bien Hoa,
3/2/2023,13960,13629,27589,4324049,VND,Binh Duong,
4/2/2023,14102,13818,27920,8697372,VND,Thu Dau Mot,
5/2/2023,14007,13865,27872,6725158,VND,Di An,
6/2/2023,13913,13795,27708,4214564,VND,Tay Ninh,
7/2/2023,14078,13936,28014,4135859,VND,Tay Ninh,
8/2/2023,25926,25259,51185,4661009,VND,Binh Phuoc,
9/2/2023,24926,24778,49704,3223124,VND,Dong Xoai,
10/2/2023,25407,25148,50555,2990114,VND,Phu Quoc,
11/2/2023,25704,25185,50889,2584574,VND,Vung Tau,
12/2/2023,39900,39450,79350,37640,VND,Ba Ria - Vung Tau,
1/2/2024,39550,39550,79100,39857,VND,Ho Chi Minh,
